"filename", "language", "TXT", "XSL", "C++", "CSV", "Shell Script", "comment", "blank", "total"
"c:\Users\Administrator\Desktop\project-C++\CPPlearning\AdminFlie.txt", "TXT", -1, 0, 0, 0, 0, 0, 0, -1
"c:\Users\Administrator\Desktop\project-C++\CPPlearning\Deep_copy\const_member.cpp", "C++", 0, 0, -27, 0, 0, -1, -1, -29
"c:\Users\Administrator\Desktop\project-C++\CPPlearning\Deep_copy\deep_copy.cpp", "C++", 0, 0, 0, 0, 0, -103, -6, -109
"c:\Users\Administrator\Desktop\project-C++\CPPlearning\Deep_copy\member_and_fun.cpp", "C++", 0, 0, 0, 0, 0, -65, -6, -71
"c:\Users\Administrator\Desktop\project-C++\CPPlearning\Deep_copy\static_Person.cpp", "C++", 0, 0, 0, 0, 0, -45, -2, -47
"c:\Users\Administrator\Desktop\project-C++\CPPlearning\EmployeeManagementSystem\Boss.cpp", "C++", 0, 0, -15, 0, 0, 0, 0, -15
"c:\Users\Administrator\Desktop\project-C++\CPPlearning\EmployeeManagementSystem\Boss.h", "C++", 0, 0, -12, 0, 0, 0, 0, -12
"c:\Users\Administrator\Desktop\project-C++\CPPlearning\EmployeeManagementSystem\EmployeeManagementSystem.cpp", "C++", 0, 0, -52, 0, 0, -9, -3, -64
"c:\Users\Administrator\Desktop\project-C++\CPPlearning\EmployeeManagementSystem\employee.cpp", "C++", 0, 0, -15, 0, 0, 0, 0, -15
"c:\Users\Administrator\Desktop\project-C++\CPPlearning\EmployeeManagementSystem\employee.h", "C++", 0, 0, -12, 0, 0, 0, 0, -12
"c:\Users\Administrator\Desktop\project-C++\CPPlearning\EmployeeManagementSystem\manager.cpp", "C++", 0, 0, -15, 0, 0, 0, 0, -15
"c:\Users\Administrator\Desktop\project-C++\CPPlearning\EmployeeManagementSystem\manager.h", "C++", 0, 0, -12, 0, 0, 0, 0, -12
"c:\Users\Administrator\Desktop\project-C++\CPPlearning\EmployeeManagementSystem\workManager.cpp", "C++", 0, 0, -536, 0, 0, -15, -8, -559
"c:\Users\Administrator\Desktop\project-C++\CPPlearning\EmployeeManagementSystem\workManager.h", "C++", 0, 0, -32, 0, 0, 0, 0, -32
"c:\Users\Administrator\Desktop\project-C++\CPPlearning\EmployeeManagementSystem\worker.h", "C++", 0, 0, -13, 0, 0, 0, 0, -13
"c:\Users\Administrator\Desktop\project-C++\CPPlearning\FileOperating\FileOperating.cpp", "C++", 0, 0, -104, 0, 0, -41, -4, -149
"c:\Users\Administrator\Desktop\project-C++\CPPlearning\FileOperating\regexTest.cpp", "C++", 0, 0, 0, 0, 0, -43, -3, -46
"c:\Users\Administrator\Desktop\project-C++\CPPlearning\Function_overloading\Function _overloading.cpp", "C++", 0, 0, 0, 0, 0, -75, -2, -77
"c:\Users\Administrator\Desktop\project-C++\CPPlearning\Function_overloading\functionPoint.cpp", "C++", 0, 0, -48, 0, 0, -7, -1, -56
"c:\Users\Administrator\Desktop\project-C++\CPPlearning\Function_study\bubble-sort.cpp", "C++", 0, 0, 0, 0, 0, -38, -1, -39
"c:\Users\Administrator\Desktop\project-C++\CPPlearning\Function_study\compare.cpp", "C++", 0, 0, -16, 0, 0, -2, 0, -18
"c:\Users\Administrator\Desktop\project-C++\CPPlearning\Function_study\cpsource.cpp", "C++", 0, 0, -6, 0, 0, 0, -2, -8
"c:\Users\Administrator\Desktop\project-C++\CPPlearning\Function_study\max.h", "C++", 0, 0, -2, 0, 0, 0, 0, -2
"c:\Users\Administrator\Desktop\project-C++\CPPlearning\Function_study\second.cpp", "C++", 0, 0, 0, 0, 0, -41, -1, -42
"c:\Users\Administrator\Desktop\project-C++\CPPlearning\Function_study\test.cpp", "C++", 0, 0, 0, 0, 0, -19, 0, -19
"c:\Users\Administrator\Desktop\project-C++\CPPlearning\Hanoi.cpp", "C++", 0, 0, -40, 0, 0, -1, 0, -41
"c:\Users\Administrator\Desktop\project-C++\CPPlearning\NewFeature\Lambda.cpp", "C++", 0, 0, 0, 0, 0, -45, -3, -48
"c:\Users\Administrator\Desktop\project-C++\CPPlearning\NewFeature\abnormal.cpp", "C++", 0, 0, 0, 0, 0, -24, -2, -26
"c:\Users\Administrator\Desktop\project-C++\CPPlearning\NewFeature\auto.cpp", "C++", 0, 0, -47, 0, 0, -35, -1, -83
"c:\Users\Administrator\Desktop\project-C++\CPPlearning\NewFeature\enumerate.cpp", "C++", 0, 0, 0, 0, 0, -48, -1, -49
"c:\Users\Administrator\Desktop\project-C++\CPPlearning\Operator overloading\AssignmentOperator_overload.cpp", "C++", 0, 0, -162, 0, 0, -3, -6, -171
"c:\Users\Administrator\Desktop\project-C++\CPPlearning\Operator overloading\IncreasingOperator_overloading.cpp", "C++", 0, 0, 0, 0, 0, -75, -4, -79
"c:\Users\Administrator\Desktop\project-C++\CPPlearning\Operator overloading\addOperator_overloading.cpp", "C++", 0, 0, 0, 0, 0, -49, 0, -49
"c:\Users\Administrator\Desktop\project-C++\CPPlearning\Operator overloading\leftOperrator_overloading.cpp", "C++", 0, 0, 0, 0, 0, -61, 0, -61
"c:\Users\Administrator\Desktop\project-C++\CPPlearning\OrderFile.txt", "TXT", -1, 0, 0, 0, 0, 0, -1, -2
"c:\Users\Administrator\Desktop\project-C++\CPPlearning\Person.txt", "TXT", -1, 0, 0, 0, 0, 0, 0, -1
"c:\Users\Administrator\Desktop\project-C++\CPPlearning\RoomFile.txt", "TXT", -3, 0, 0, 0, 0, 0, 0, -3
"c:\Users\Administrator\Desktop\project-C++\CPPlearning\RoomReservationSystem\RoomReserveSys.cpp", "C++", 0, 0, -220, 0, 0, -17, -2, -239
"c:\Users\Administrator\Desktop\project-C++\CPPlearning\RoomReservationSystem\administrator.cpp", "C++", 0, 0, -617, 0, 0, -16, -3, -636
"c:\Users\Administrator\Desktop\project-C++\CPPlearning\RoomReservationSystem\administrator.h", "C++", 0, 0, -36, 0, 0, -9, 0, -45
"c:\Users\Administrator\Desktop\project-C++\CPPlearning\RoomReservationSystem\computerRoom.cpp", "C++", 0, 0, -27, 0, 0, 0, -1, -28
"c:\Users\Administrator\Desktop\project-C++\CPPlearning\RoomReservationSystem\computerRoom.h", "C++", 0, 0, -17, 0, 0, 0, -1, -18
"c:\Users\Administrator\Desktop\project-C++\CPPlearning\RoomReservationSystem\globalFile.h", "C++", 0, 0, -5, 0, 0, -5, 0, -10
"c:\Users\Administrator\Desktop\project-C++\CPPlearning\RoomReservationSystem\identity.h", "C++", 0, 0, -14, 0, 0, 0, 0, -14
"c:\Users\Administrator\Desktop\project-C++\CPPlearning\RoomReservationSystem\orderReserve.cpp", "C++", 0, 0, -66, 0, 0, -14, 0, -80
"c:\Users\Administrator\Desktop\project-C++\CPPlearning\RoomReservationSystem\orderReserve.h", "C++", 0, 0, -17, 0, 0, -4, -1, -22
"c:\Users\Administrator\Desktop\project-C++\CPPlearning\RoomReservationSystem\student.cpp", "C++", 0, 0, -373, 0, 0, -18, -3, -394
"c:\Users\Administrator\Desktop\project-C++\CPPlearning\RoomReservationSystem\student.h", "C++", 0, 0, -27, 0, 0, -3, 0, -30
"c:\Users\Administrator\Desktop\project-C++\CPPlearning\RoomReservationSystem\teacher.cpp", "C++", 0, 0, -196, 0, 0, -2, -3, -201
"c:\Users\Administrator\Desktop\project-C++\CPPlearning\RoomReservationSystem\teacher.h", "C++", 0, 0, -19, 0, 0, -2, -1, -22
"c:\Users\Administrator\Desktop\project-C++\CPPlearning\STLStudy\Case1.cpp", "C++", 0, 0, 0, 0, 0, -118, -1, -119
"c:\Users\Administrator\Desktop\project-C++\CPPlearning\STLStudy\ObjectFunction.cpp", "C++", 0, 0, 0, 0, 0, -75, 0, -75
"c:\Users\Administrator\Desktop\project-C++\CPPlearning\STLStudy\STLCase.cpp", "C++", 0, 0, 0, 0, 0, -90, -1, -91
"c:\Users\Administrator\Desktop\project-C++\CPPlearning\STLStudy\STL_first.cpp", "C++", 0, 0, 0, 0, 0, -68, 0, -68
"c:\Users\Administrator\Desktop\project-C++\CPPlearning\STLStudy\StringLearnig.cpp", "C++", 0, 0, -174, 0, 0, -39, -2, -215
"c:\Users\Administrator\Desktop\project-C++\CPPlearning\STLStudy\commen.hpp", "C++", 0, 0, 0, 0, 0, -17, 0, -17
"c:\Users\Administrator\Desktop\project-C++\CPPlearning\STLStudy\dequeLearning.cpp", "C++", 0, 0, 0, 0, 0, -160, -2, -162
"c:\Users\Administrator\Desktop\project-C++\CPPlearning\STLStudy\insightFuncOBJ.cpp", "C++", 0, 0, 0, 0, 0, -72, -1, -73
"c:\Users\Administrator\Desktop\project-C++\CPPlearning\STLStudy\listCase.cpp", "C++", 0, 0, 0, 0, 0, -56, 0, -56
"c:\Users\Administrator\Desktop\project-C++\CPPlearning\STLStudy\listLearning.cpp", "C++", 0, 0, 0, 0, 0, -110, -1, -111
"c:\Users\Administrator\Desktop\project-C++\CPPlearning\STLStudy\map_multimap.cpp", "C++", 0, 0, 0, 0, 0, -163, -2, -165
"c:\Users\Administrator\Desktop\project-C++\CPPlearning\STLStudy\predicate.cpp", "C++", 0, 0, 0, 0, 0, -86, -1, -87
"c:\Users\Administrator\Desktop\project-C++\CPPlearning\STLStudy\set_multiset.cpp", "C++", 0, 0, 0, 0, 0, -195, 0, -195
"c:\Users\Administrator\Desktop\project-C++\CPPlearning\STLStudy\stackLearning.cpp", "C++", 0, 0, 0, 0, 0, -53, -1, -54
"c:\Users\Administrator\Desktop\project-C++\CPPlearning\STLStudy\vectorTest.cpp", "C++", 0, 0, 0, 0, 0, -242, -2, -244
"c:\Users\Administrator\Desktop\project-C++\CPPlearning\STL_Algorithm\ArithGen.cpp", "C++", 0, 0, -122, 0, 0, -12, 0, -134
"c:\Users\Administrator\Desktop\project-C++\CPPlearning\STL_Algorithm\ErgodicALG.cpp", "C++", 0, 0, 0, 0, 0, -68, 0, -68
"c:\Users\Administrator\Desktop\project-C++\CPPlearning\STL_Algorithm\FindALG.cpp", "C++", 0, 0, 0, 0, 0, -185, -2, -187
"c:\Users\Administrator\Desktop\project-C++\CPPlearning\STL_Algorithm\commen.hpp", "C++", 0, 0, -69, 0, 0, 0, -1, -70
"c:\Users\Administrator\Desktop\project-C++\CPPlearning\STL_Algorithm\random_shuffe.cpp", "C++", 0, 0, 0, 0, 0, -146, 0, -146
"c:\Users\Administrator\Desktop\project-C++\CPPlearning\SpeechContestSystem\Speaker.hpp", "C++", 0, 0, -41, 0, 0, 0, 0, -41
"c:\Users\Administrator\Desktop\project-C++\CPPlearning\SpeechContestSystem\SpeechContestManSys.cpp", "C++", 0, 0, -34, 0, 0, -1, -2, -37
"c:\Users\Administrator\Desktop\project-C++\CPPlearning\SpeechContestSystem\SpeechManager.cpp", "C++", 0, 0, -310, 0, 0, -29, -4, -343
"c:\Users\Administrator\Desktop\project-C++\CPPlearning\SpeechContestSystem\SpeechManager.h", "C++", 0, 0, -46, 0, 0, 0, 0, -46
"c:\Users\Administrator\Desktop\project-C++\CPPlearning\StudentFile.txt", "TXT", -7, 0, 0, 0, 0, 0, -1, -8
"c:\Users\Administrator\Desktop\project-C++\CPPlearning\TeacherFile.txt", "TXT", -1, 0, 0, 0, 0, 0, -1, -2
"c:\Users\Administrator\Desktop\project-C++\CPPlearning\TemplateLearning\ClassTemplate.cpp", "C++", 0, 0, -85, 0, 0, -14, -1, -100
"c:\Users\Administrator\Desktop\project-C++\CPPlearning\TemplateLearning\ClasstempInherit.cpp", "C++", 0, 0, 0, 0, 0, -104, -3, -107
"c:\Users\Administrator\Desktop\project-C++\CPPlearning\TemplateLearning\Common_Template.cpp", "C++", 0, 0, 0, 0, 0, -155, -2, -157
"c:\Users\Administrator\Desktop\project-C++\CPPlearning\TemplateLearning\FunctionTemplate.cpp", "C++", 0, 0, 0, 0, 0, -56, -1, -57
"c:\Users\Administrator\Desktop\project-C++\CPPlearning\TemplateLearning\Sort_Template.cpp", "C++", 0, 0, 0, 0, 0, -156, -3, -159
"c:\Users\Administrator\Desktop\project-C++\CPPlearning\TemplateLearning\example.cpp", "C++", 0, 0, 0, 0, 0, -100, -1, -101
"c:\Users\Administrator\Desktop\project-C++\CPPlearning\TemplateLearning\example.hpp", "C++", 0, 0, -376, 0, 0, -18, -7, -401
"c:\Users\Administrator\Desktop\project-C++\CPPlearning\TestFile.txt", "TXT", -6, 0, 0, 0, 0, 0, -2, -8
"c:\Users\Administrator\Desktop\project-C++\CPPlearning\class_learn\circle.cpp", "C++", 0, 0, -28, 0, 0, 0, -1, -29
"c:\Users\Administrator\Desktop\project-C++\CPPlearning\class_learn\circle.h", "C++", 0, 0, -16, 0, 0, -2, -6, -24
"c:\Users\Administrator\Desktop\project-C++\CPPlearning\class_learn\person.cpp", "C++", 0, 0, 0, 0, 0, -26, -5, -31
"c:\Users\Administrator\Desktop\project-C++\CPPlearning\class_learn\point.cpp", "C++", 0, 0, -17, 0, 0, 0, 0, -17
"c:\Users\Administrator\Desktop\project-C++\CPPlearning\class_learn\point.h", "C++", 0, 0, -15, 0, 0, -1, -6, -22
"c:\Users\Administrator\Desktop\project-C++\CPPlearning\class_learn\structure_fun.cpp", "C++", 0, 0, 0, 0, 0, -68, -7, -75
"c:\Users\Administrator\Desktop\project-C++\CPPlearning\class_learn\test_circle.cpp", "C++", 0, 0, -36, 0, 0, -2, -2, -40
"c:\Users\Administrator\Desktop\project-C++\CPPlearning\epmFile.txt", "TXT", -1, 0, 0, 0, 0, 0, -1, -2
"c:\Users\Administrator\Desktop\project-C++\CPPlearning\friend\good_friend.cpp", "C++", 0, 0, -79, 0, 0, -3, -7, -89
"c:\Users\Administrator\Desktop\project-C++\CPPlearning\inherit_learning\inherit.cpp", "C++", 0, 0, 0, 0, 0, -124, 0, -124
"c:\Users\Administrator\Desktop\project-C++\CPPlearning\inherit_learning\inherit_manner.cpp", "C++", 0, 0, 0, 0, 0, -149, -7, -156
"c:\Users\Administrator\Desktop\project-C++\CPPlearning\inherit_learning\multiInherit.cpp", "C++", 0, 0, 0, 0, 0, -99, -9, -108
"c:\Users\Administrator\Desktop\project-C++\CPPlearning\inherit_learning\multi_multi_inherit.cpp", "C++", 0, 0, 0, 0, 0, -37, 0, -37
"c:\Users\Administrator\Desktop\project-C++\CPPlearning\naworkAuthtic.sh", "Shell Script", 0, 0, 0, 0, -32, 0, -1, -33
"c:\Users\Administrator\Desktop\project-C++\CPPlearning\polymorphic\ComputerAssembly.cpp", "C++", 0, 0, -125, 0, 0, -6, -3, -134
"c:\Users\Administrator\Desktop\project-C++\CPPlearning\polymorphic\PureDestruction.cpp", "C++", 0, 0, 0, 0, 0, -93, -5, -98
"c:\Users\Administrator\Desktop\project-C++\CPPlearning\polymorphic\PureVirtualFunctions.cpp", "C++", 0, 0, 0, 0, 0, -37, -2, -39
"c:\Users\Administrator\Desktop\project-C++\CPPlearning\polymorphic\caculator.cpp", "C++", 0, 0, 0, 0, 0, -112, -2, -114
"c:\Users\Administrator\Desktop\project-C++\CPPlearning\polymorphic\drinkMading.cpp", "C++", 0, 0, 0, 0, 0, -88, -1, -89
"c:\Users\Administrator\Desktop\project-C++\CPPlearning\polymorphic\polymorphic.cpp", "C++", 0, 0, 0, 0, 0, -66, -1, -67
"c:\Users\Administrator\Desktop\project-C++\CPPlearning\reference_learn\refer_learn.cpp", "C++", 0, 0, -133, 0, 0, -40, -1, -174
"c:\Users\Administrator\Desktop\project-C++\CPPlearning\speech.csv", "CSV", 0, 0, 0, 0, 0, 0, -1, -1
"c:\Users\Administrator\Desktop\project-C++\CPPlearning\speechRecord.csv", "CSV", 0, 0, 0, 0, 0, 0, -1, -1
"c:\Users\Administrator\Desktop\project-C++\CPPlearning\struct-study\reference-test.cpp", "C++", 0, 0, 0, 0, 0, -21, -1, -22
"c:\Users\Administrator\Desktop\project-C++\CPPlearning\struct-study\struct-array copy.cpp", "C++", 0, 0, 0, 0, 0, -32, -2, -34
"c:\Users\Administrator\Desktop\project-C++\CPPlearning\struct-study\struct-array.cpp", "C++", 0, 0, 0, 0, 0, -26, -1, -27
"c:\Users\Administrator\Desktop\project-C++\CPPlearning\struct-study\struct-first.cpp", "C++", 0, 0, -51, 0, 0, -14, -4, -69
"c:\Users\Administrator\Desktop\project-C++\CPPlearning\test.xsl", "XSL", 0, -3, 0, 0, 0, 0, -1, -4
"c:\Users\Administrator\Desktop\project-C++\CPPlearning\text.txt", "TXT", -6, 0, 0, 0, 0, 0, -1, -7
"c:\Users\Administrator\Desktop\project-C++\CPPlearning\workTime.txt", "TXT", -4, 0, 0, 0, 0, 0, 0, -4
"e:\project-C++\CPPlearning\AdminFlie.txt", "TXT", 1, 0, 0, 0, 0, 0, 0, 1
"e:\project-C++\CPPlearning\Deep_copy\const_member.cpp", "C++", 0, 0, 27, 0, 0, 1, 1, 29
"e:\project-C++\CPPlearning\Deep_copy\deep_copy.cpp", "C++", 0, 0, 0, 0, 0, 103, 6, 109
"e:\project-C++\CPPlearning\Deep_copy\member_and_fun.cpp", "C++", 0, 0, 0, 0, 0, 65, 6, 71
"e:\project-C++\CPPlearning\Deep_copy\static_Person.cpp", "C++", 0, 0, 0, 0, 0, 45, 2, 47
"e:\project-C++\CPPlearning\EmployeeManagementSystem\Boss.cpp", "C++", 0, 0, 15, 0, 0, 0, 0, 15
"e:\project-C++\CPPlearning\EmployeeManagementSystem\Boss.h", "C++", 0, 0, 12, 0, 0, 0, 0, 12
"e:\project-C++\CPPlearning\EmployeeManagementSystem\EmployeeManagementSystem.cpp", "C++", 0, 0, 52, 0, 0, 9, 3, 64
"e:\project-C++\CPPlearning\EmployeeManagementSystem\employee.cpp", "C++", 0, 0, 15, 0, 0, 0, 0, 15
"e:\project-C++\CPPlearning\EmployeeManagementSystem\employee.h", "C++", 0, 0, 12, 0, 0, 0, 0, 12
"e:\project-C++\CPPlearning\EmployeeManagementSystem\manager.cpp", "C++", 0, 0, 15, 0, 0, 0, 0, 15
"e:\project-C++\CPPlearning\EmployeeManagementSystem\manager.h", "C++", 0, 0, 12, 0, 0, 0, 0, 12
"e:\project-C++\CPPlearning\EmployeeManagementSystem\workManager.cpp", "C++", 0, 0, 536, 0, 0, 15, 8, 559
"e:\project-C++\CPPlearning\EmployeeManagementSystem\workManager.h", "C++", 0, 0, 32, 0, 0, 0, 0, 32
"e:\project-C++\CPPlearning\EmployeeManagementSystem\worker.h", "C++", 0, 0, 13, 0, 0, 0, 0, 13
"e:\project-C++\CPPlearning\FileOperating\FileOperating.cpp", "C++", 0, 0, 104, 0, 0, 41, 4, 149
"e:\project-C++\CPPlearning\FileOperating\regexTest.cpp", "C++", 0, 0, 0, 0, 0, 43, 3, 46
"e:\project-C++\CPPlearning\Function_overloading\Function _overloading.cpp", "C++", 0, 0, 0, 0, 0, 75, 2, 77
"e:\project-C++\CPPlearning\Function_overloading\functionPoint.cpp", "C++", 0, 0, 48, 0, 0, 7, 1, 56
"e:\project-C++\CPPlearning\Function_study\bubble-sort.cpp", "C++", 0, 0, 0, 0, 0, 38, 1, 39
"e:\project-C++\CPPlearning\Function_study\compare.cpp", "C++", 0, 0, 16, 0, 0, 2, 0, 18
"e:\project-C++\CPPlearning\Function_study\cpsource.cpp", "C++", 0, 0, 6, 0, 0, 0, 2, 8
"e:\project-C++\CPPlearning\Function_study\max.h", "C++", 0, 0, 2, 0, 0, 0, 0, 2
"e:\project-C++\CPPlearning\Function_study\second.cpp", "C++", 0, 0, 0, 0, 0, 41, 1, 42
"e:\project-C++\CPPlearning\Function_study\test.cpp", "C++", 0, 0, 0, 0, 0, 19, 0, 19
"e:\project-C++\CPPlearning\Hanoi.cpp", "C++", 0, 0, 40, 0, 0, 1, 0, 41
"e:\project-C++\CPPlearning\NewFeature\Lambda.cpp", "C++", 0, 0, 0, 0, 0, 45, 3, 48
"e:\project-C++\CPPlearning\NewFeature\abnormal.cpp", "C++", 0, 0, 0, 0, 0, 24, 2, 26
"e:\project-C++\CPPlearning\NewFeature\auto.cpp", "C++", 0, 0, 47, 0, 0, 35, 1, 83
"e:\project-C++\CPPlearning\NewFeature\enumerate.cpp", "C++", 0, 0, 0, 0, 0, 48, 1, 49
"e:\project-C++\CPPlearning\Operator overloading\AssignmentOperator_overload.cpp", "C++", 0, 0, 162, 0, 0, 3, 6, 171
"e:\project-C++\CPPlearning\Operator overloading\IncreasingOperator_overloading.cpp", "C++", 0, 0, 0, 0, 0, 75, 4, 79
"e:\project-C++\CPPlearning\Operator overloading\addOperator_overloading.cpp", "C++", 0, 0, 0, 0, 0, 49, 0, 49
"e:\project-C++\CPPlearning\Operator overloading\leftOperrator_overloading.cpp", "C++", 0, 0, 0, 0, 0, 61, 0, 61
"e:\project-C++\CPPlearning\OrderFile.txt", "TXT", 1, 0, 0, 0, 0, 0, 1, 2
"e:\project-C++\CPPlearning\Person.txt", "TXT", 1, 0, 0, 0, 0, 0, 0, 1
"e:\project-C++\CPPlearning\RoomFile.txt", "TXT", 3, 0, 0, 0, 0, 0, 0, 3
"e:\project-C++\CPPlearning\RoomReservationSystem\RoomReserveSys.cpp", "C++", 0, 0, 220, 0, 0, 17, 2, 239
"e:\project-C++\CPPlearning\RoomReservationSystem\administrator.cpp", "C++", 0, 0, 617, 0, 0, 16, 3, 636
"e:\project-C++\CPPlearning\RoomReservationSystem\administrator.h", "C++", 0, 0, 36, 0, 0, 9, 0, 45
"e:\project-C++\CPPlearning\RoomReservationSystem\computerRoom.cpp", "C++", 0, 0, 27, 0, 0, 0, 1, 28
"e:\project-C++\CPPlearning\RoomReservationSystem\computerRoom.h", "C++", 0, 0, 17, 0, 0, 0, 1, 18
"e:\project-C++\CPPlearning\RoomReservationSystem\globalFile.h", "C++", 0, 0, 5, 0, 0, 5, 0, 10
"e:\project-C++\CPPlearning\RoomReservationSystem\identity.h", "C++", 0, 0, 14, 0, 0, 0, 0, 14
"e:\project-C++\CPPlearning\RoomReservationSystem\orderReserve.cpp", "C++", 0, 0, 66, 0, 0, 14, 0, 80
"e:\project-C++\CPPlearning\RoomReservationSystem\orderReserve.h", "C++", 0, 0, 17, 0, 0, 4, 1, 22
"e:\project-C++\CPPlearning\RoomReservationSystem\student.cpp", "C++", 0, 0, 373, 0, 0, 18, 3, 394
"e:\project-C++\CPPlearning\RoomReservationSystem\student.h", "C++", 0, 0, 27, 0, 0, 3, 0, 30
"e:\project-C++\CPPlearning\RoomReservationSystem\teacher.cpp", "C++", 0, 0, 196, 0, 0, 2, 3, 201
"e:\project-C++\CPPlearning\RoomReservationSystem\teacher.h", "C++", 0, 0, 19, 0, 0, 2, 1, 22
"e:\project-C++\CPPlearning\STLStudy\Case1.cpp", "C++", 0, 0, 0, 0, 0, 118, 1, 119
"e:\project-C++\CPPlearning\STLStudy\ObjectFunction.cpp", "C++", 0, 0, 0, 0, 0, 75, 0, 75
"e:\project-C++\CPPlearning\STLStudy\STLCase.cpp", "C++", 0, 0, 0, 0, 0, 90, 1, 91
"e:\project-C++\CPPlearning\STLStudy\STL_first.cpp", "C++", 0, 0, 0, 0, 0, 68, 0, 68
"e:\project-C++\CPPlearning\STLStudy\StringLearnig.cpp", "C++", 0, 0, 174, 0, 0, 39, 2, 215
"e:\project-C++\CPPlearning\STLStudy\commen.hpp", "C++", 0, 0, 0, 0, 0, 17, 0, 17
"e:\project-C++\CPPlearning\STLStudy\dequeLearning.cpp", "C++", 0, 0, 0, 0, 0, 160, 2, 162
"e:\project-C++\CPPlearning\STLStudy\insightFuncOBJ.cpp", "C++", 0, 0, 0, 0, 0, 72, 1, 73
"e:\project-C++\CPPlearning\STLStudy\listCase.cpp", "C++", 0, 0, 0, 0, 0, 56, 0, 56
"e:\project-C++\CPPlearning\STLStudy\listLearning.cpp", "C++", 0, 0, 0, 0, 0, 110, 1, 111
"e:\project-C++\CPPlearning\STLStudy\map_multimap.cpp", "C++", 0, 0, 0, 0, 0, 163, 2, 165
"e:\project-C++\CPPlearning\STLStudy\predicate.cpp", "C++", 0, 0, 0, 0, 0, 86, 1, 87
"e:\project-C++\CPPlearning\STLStudy\set_multiset.cpp", "C++", 0, 0, 0, 0, 0, 195, 0, 195
"e:\project-C++\CPPlearning\STLStudy\stackLearning.cpp", "C++", 0, 0, 0, 0, 0, 53, 1, 54
"e:\project-C++\CPPlearning\STLStudy\vectorTest.cpp", "C++", 0, 0, 0, 0, 0, 242, 2, 244
"e:\project-C++\CPPlearning\STL_Algorithm\ArithGen.cpp", "C++", 0, 0, 122, 0, 0, 12, 0, 134
"e:\project-C++\CPPlearning\STL_Algorithm\ErgodicALG.cpp", "C++", 0, 0, 0, 0, 0, 68, 0, 68
"e:\project-C++\CPPlearning\STL_Algorithm\FindALG.cpp", "C++", 0, 0, 0, 0, 0, 185, 2, 187
"e:\project-C++\CPPlearning\STL_Algorithm\commen.hpp", "C++", 0, 0, 69, 0, 0, 0, 1, 70
"e:\project-C++\CPPlearning\STL_Algorithm\random_shuffe.cpp", "C++", 0, 0, 0, 0, 0, 146, 0, 146
"e:\project-C++\CPPlearning\SpeechContestSystem\Speaker.hpp", "C++", 0, 0, 41, 0, 0, 0, 0, 41
"e:\project-C++\CPPlearning\SpeechContestSystem\SpeechContestManSys.cpp", "C++", 0, 0, 34, 0, 0, 1, 2, 37
"e:\project-C++\CPPlearning\SpeechContestSystem\SpeechManager.cpp", "C++", 0, 0, 310, 0, 0, 29, 4, 343
"e:\project-C++\CPPlearning\SpeechContestSystem\SpeechManager.h", "C++", 0, 0, 46, 0, 0, 0, 0, 46
"e:\project-C++\CPPlearning\StudentFile.txt", "TXT", 7, 0, 0, 0, 0, 0, 1, 8
"e:\project-C++\CPPlearning\TeacherFile.txt", "TXT", 1, 0, 0, 0, 0, 0, 1, 2
"e:\project-C++\CPPlearning\TemplateLearning\ClassTemplate.cpp", "C++", 0, 0, 85, 0, 0, 14, 1, 100
"e:\project-C++\CPPlearning\TemplateLearning\ClasstempInherit.cpp", "C++", 0, 0, 0, 0, 0, 104, 3, 107
"e:\project-C++\CPPlearning\TemplateLearning\Common_Template.cpp", "C++", 0, 0, 0, 0, 0, 155, 2, 157
"e:\project-C++\CPPlearning\TemplateLearning\FunctionTemplate.cpp", "C++", 0, 0, 0, 0, 0, 56, 1, 57
"e:\project-C++\CPPlearning\TemplateLearning\Sort_Template.cpp", "C++", 0, 0, 0, 0, 0, 156, 3, 159
"e:\project-C++\CPPlearning\TemplateLearning\example.cpp", "C++", 0, 0, 0, 0, 0, 100, 1, 101
"e:\project-C++\CPPlearning\TemplateLearning\example.hpp", "C++", 0, 0, 376, 0, 0, 18, 7, 401
"e:\project-C++\CPPlearning\TestFile.txt", "TXT", 6, 0, 0, 0, 0, 0, 2, 8
"e:\project-C++\CPPlearning\class_learn\circle.cpp", "C++", 0, 0, 28, 0, 0, 0, 1, 29
"e:\project-C++\CPPlearning\class_learn\circle.h", "C++", 0, 0, 16, 0, 0, 2, 6, 24
"e:\project-C++\CPPlearning\class_learn\person.cpp", "C++", 0, 0, 0, 0, 0, 26, 5, 31
"e:\project-C++\CPPlearning\class_learn\point.cpp", "C++", 0, 0, 17, 0, 0, 0, 0, 17
"e:\project-C++\CPPlearning\class_learn\point.h", "C++", 0, 0, 15, 0, 0, 1, 6, 22
"e:\project-C++\CPPlearning\class_learn\structure_fun.cpp", "C++", 0, 0, 0, 0, 0, 68, 7, 75
"e:\project-C++\CPPlearning\class_learn\test_circle.cpp", "C++", 0, 0, 36, 0, 0, 2, 2, 40
"e:\project-C++\CPPlearning\epmFile.txt", "TXT", 1, 0, 0, 0, 0, 0, 1, 2
"e:\project-C++\CPPlearning\friend\good_friend.cpp", "C++", 0, 0, 79, 0, 0, 3, 7, 89
"e:\project-C++\CPPlearning\inherit_learning\inherit.cpp", "C++", 0, 0, 0, 0, 0, 124, 0, 124
"e:\project-C++\CPPlearning\inherit_learning\inherit_manner.cpp", "C++", 0, 0, 0, 0, 0, 149, 7, 156
"e:\project-C++\CPPlearning\inherit_learning\multiInherit.cpp", "C++", 0, 0, 0, 0, 0, 99, 9, 108
"e:\project-C++\CPPlearning\inherit_learning\multi_multi_inherit.cpp", "C++", 0, 0, 0, 0, 0, 37, 0, 37
"e:\project-C++\CPPlearning\naworkAuthtic.sh", "Shell Script", 0, 0, 0, 0, 32, 0, 1, 33
"e:\project-C++\CPPlearning\polymorphic\ComputerAssembly.cpp", "C++", 0, 0, 125, 0, 0, 6, 3, 134
"e:\project-C++\CPPlearning\polymorphic\PureDestruction.cpp", "C++", 0, 0, 0, 0, 0, 93, 5, 98
"e:\project-C++\CPPlearning\polymorphic\PureVirtualFunctions.cpp", "C++", 0, 0, 0, 0, 0, 37, 2, 39
"e:\project-C++\CPPlearning\polymorphic\caculator.cpp", "C++", 0, 0, 0, 0, 0, 112, 2, 114
"e:\project-C++\CPPlearning\polymorphic\drinkMading.cpp", "C++", 0, 0, 0, 0, 0, 88, 1, 89
"e:\project-C++\CPPlearning\polymorphic\polymorphic.cpp", "C++", 0, 0, 0, 0, 0, 66, 1, 67
"e:\project-C++\CPPlearning\reference_learn\refer_learn.cpp", "C++", 0, 0, 133, 0, 0, 40, 1, 174
"e:\project-C++\CPPlearning\speech.csv", "CSV", 0, 0, 0, 0, 0, 0, 1, 1
"e:\project-C++\CPPlearning\speechRecord.csv", "CSV", 0, 0, 0, 0, 0, 0, 1, 1
"e:\project-C++\CPPlearning\struct-study\reference-test.cpp", "C++", 0, 0, 0, 0, 0, 21, 1, 22
"e:\project-C++\CPPlearning\struct-study\struct-array copy.cpp", "C++", 0, 0, 0, 0, 0, 32, 2, 34
"e:\project-C++\CPPlearning\struct-study\struct-array.cpp", "C++", 0, 0, 0, 0, 0, 26, 1, 27
"e:\project-C++\CPPlearning\struct-study\struct-first.cpp", "C++", 0, 0, 51, 0, 0, 14, 4, 69
"e:\project-C++\CPPlearning\test.xsl", "XSL", 0, 3, 0, 0, 0, 0, 1, 4
"e:\project-C++\CPPlearning\text.txt", "TXT", 6, 0, 0, 0, 0, 0, 1, 7
"e:\project-C++\CPPlearning\workTime.txt", "TXT", 4, 0, 0, 0, 0, 0, 0, 4
"Total", "-", 0, 0, 0, 0, 0, 0, 0, 0